2 13 31
###############################
#p * *2       *  ** *x* 4    *#
# # # # #*# # #*# # # # # #*# #
#    * * *** **      *    **  #
# #*# # # # #1# #b#1# # # # #*#
#          *     **7     *  **#
# # #*# # # # # #*#*#*#*# # # #
#   *    7   *   ***** *      #
# # # # #*#*# #*# # # #*# #*# #
#   ****         *1           #
# # # # # # # # # #*# # # # #*#
#  **x*   *    3    ****5   **#
###############################